Resources\TiledMap\MAP_BOSS_tiles.png
1,2,3,4,4,5,6,7,8,9,3,4,10,11,8,12,
9,13,4,4,5,14,4,4,9,15,4,4,4,16,8,9,
15,17,18,19,20,21,18,19,6,7,4,20,10,11,8,12,
22,9,4,21,4,4,4,21,4,4,21,21,4,16,8,9,
15,17,4,20,18,19,4,5,20,21,20,21,10,11,8,12,
22,9,4,21,4,21,5,14,4,4,4,4,4,16,8,9,
1,23,24,4,20,21,20,4,18,19,20,4,10,11,8,12,
9,25,26,27,4,4,28,27,4,21,28,27,4,16,8,9,
1,29,30,31,32,32,33,34,32,32,35,31,32,32,8,12,
9,36,37,38,39,38,39,38,39,38,40,38,39,38,8,9,
1,2,9,1,41,22,15,17,41,22,9,1,41,22,15,17,
42,42,42,42,42,42,42,42,42,42,42,42,42,42,42,42,
