0 0 0 249 107 19 28 1
1 0 0 294 106 22 29 1
2 0 0 343 108 20 27 1
3 0 0 441 103 20 32 1
4 0 0 1287 71 19 28 1
5 0 0 1445 71 16 27 1
6 0 0 1482 40 18 25 1
7 0 0 1880 107 18 25 1
8 0 0 1958 106 22 28 1
9 1 0 331 91 12 16 1
10 1 0 428 90 13 15 1
11 1 0 573 90 13 13 1
12 1 0 769 59 9 16 1
13 1 0 892 26 11 16 1
14 1 0 635 75 8 14 1
15 1 0 1152 91 10 14 1
16 1 0 1182 27 8 13 1
17 1 0 1326 27 12 13 1
18 1 0 1662 90 12 13 1
19 1 0 1856 94 10 12 1
20 2 0 555 28 14 14 1
21 2 0 714 30 14 13 1
22 2 0 1568 47 12 12 1
23 2 0 1722 30 16 14 1
24 2 0 1866 31 16 14 1
25 2 0 1053 43 15 15 1
26 3 0 228 123 18 15 1
27 3 0 1275 122 18 14 1
28 4 0 805 68 18 23 1
29 4 0 1208 71 13 22 1
30 5 0 1367 95 15 28 1
