0 0 0 296 77 18 24 1 
1 0 0 380 78 17 22 1 
2 0 0 870 76 17 24 1 
3 0 0 1157 106 19 25 1 
4 0 0 1220 109 19 22 1 
5 0 0 1898 10 21 25 1 
6 0 0 2968 108 20 25 1 
7 2 0 905 1 15 13 1 
8 2 0 1419 10 15 15 1 
9 2 0 2396 5 15 13 1 
10 2 0 2671 13 16 15 1 
11 2 0 2992 13 12 14 1 
12 3 0 2731 0 19 14 1 
13 4 0 1055 80 19 23 1 
14 4 0 1145 0 16 22 1 
15 6 1 348 57 14 17 1 
16 6 1 444 27 15 12 1 
17 6 1 704 5 8 11 1 
18 6 1 1011 24 7 16 1 
19 6 1 1149 87 13 13 1 
20 6 1 1390 28 11 12 1 
21 6 1 1501 29 11 12 1 
22 6 1 1665 72 16 12 1 
23 6 1 1817 94 22 7 1 
24 6 1 2078 43 10 13 1 
25 6 1 2187 27 13 12 1 
26 6 1 2366 58 12 13 1 
27 6 1 2493 57 13 14 1 
28 6 1 2621 44 13 11 1 
29 6 1 2829 27 13 12 1 
30 7 0 505 30 18 17 1 
31 7 0 650 0 20 1 
32 7 0 1480 50 22 15 1 
33 7 0 2089 20 15 17 1 
34 7 0 2281 95 16 20 1 
35 7 0 2465 95 14 21 1 
36 7 0 2670 0 19 21 1 
37 8 0 1565 10 17 20 1 
38 8 1 1616 0 13 28 1 
39 8 0 1657 0 14 23 1 
40 2 1 1435 0 15 13 1 