0 0 0 296 77 18 24 1
1 0 0 392 78 17 22 1
2 0 0 876 76 17 24 1
3 0 0 1160 106 19 25 1
4 0 0 1225 109 19 22 1
5 0 0 1898 10 21 25 1
6 0 0 2968 108 20 25 1
7 2 0 905 1 15 13 1
8 2 0 1419 10 15 15 1
9 2 0 2396 11 15 13 1
10 2 0 2671 13 16 15 1
11 2 0 2992 13 12 14 1
12 3 0 2731 57 19 14 1
13 4 0 1067 110 19 23 1
14 4 0 1164 14 16 22 1
15 6 0 348 57 14 17 1
16 6 0 444 27 15 12 1
17 6 0 704 12 8 11 1
18 6 0 1011 24 7 16 1
19 6 0 1149 87 13 13 1
20 6 0 1390 28 11 12 1
21 6 0 1501 29 11 12 1
22 6 0 1674 72 16 12 1
23 6 0 1817 94 22 7 1
24 6 0 2078 43 10 13 1
25 6 0 2187 27 13 12 1
26 6 0 2366 58 12 13 1
27 6 0 2493 57 13 14 1
28 6 0 2621 44 13 11 1
29 6 0 2829 27 13 12 1
30 7 0 520 35 18 17 1
31 7 0 650 5 20 1
32 7 0 1480 70 22 15 1
33 7 0 2089 70 15 17 1
34 7 0 2281 95 16 20 1
35 7 0 2477 95 14 21 1
36 7 0 2680 65 19 21 1
37 8 0 1573 35 17 20 1
38 8 0 1616 3 13 28 1
39 8 0 1657 5 14 23 1
