0 0 0 242 137 26 32 1
1 0 0 287 136 29 32 1
2 0 0 335 136 28 34 1
3 0 0 436 134 28 33 1
4 0 0 1281 69 26 33 1
5 0 0 1437 68 29 37 1
6 0 0 1475 38 25 32 1
7 0 0 1873 134 26 34 1
27 1 0 1319 57 21 17 1
26 1 0 1175 55 18 18 1
21 1 0 426 121 17 15 1
20 1 0 327 121 18 16 1
22 1 0 568 120 18 21 1
23 1 0 761 90 18 17 1
24 1 0 887 57 18 18 1
25 1 0 1146 122 18 15 1
28 1 0 1653 119 22 20 1
29 1 0 1847 122 20 17 1
30 0 0 1954 136 30 36 1
31 2 0 551 53 20 23 1
32 2 0 709 51 22 24 1
33 2 0 1049 66 20 24 1
34 2 0 1561 63 25 29 1
35 2 0 1722 48 21 28 1
36 2 0 1861 51 27 24 1
40 4 0 803 102 24 33 1
39 4 0 1203 72 30 31 1
41 5 0 1365 138 20 28 1
42 6 0 617 136 26 19 1
43 1 0 630 104 18 15 1
